XXXXXXXXXXXXXXXXXXXXXXXXXXXXXXXXXXXXXXXXXXXXXXXXXXXXXXX
X . . . . . . . . . . . . XXX . . . . . . . . . . . . X
X . XXXXXXX . XXXXXXXXX . XXX . XXXXXXXXX . XXXXXXX . X
X O XXXXXXX . XXXXXXXXX . XXX . XXXXXXXXX . XXXXXXX O X
X . XXXXXXX . XXXXXXXXX . XXX . XXXXXXXXX . XXXXXXX . X
X . . . . . . . . . . . . . . . . . . . . . . . . . . X
X . XXXXXXX . XXX . XXXXXXXXXXXXXXX . XXX . XXXXXXX . X
X . XXXXXXX . XXX . XXXXXXXXXXXXXXX . XXX . XXXXXXX . X
X . . . . . . XXX . . . . XXX . . . . XXX . . . . . . X
XXXXXXXXXXX . XXXXXXXXX   XXX   XXXXXXXXX . XXXXXXXXXXX
          X . XXX                     XXX . X
          X . XXX                     XXX . X
XXXXXXXXXXX . XXX   XXXXXoooooXXXXX   XXX . XXXXXXXXXXX
X           .       X             X       .           X
h           .       X             X       .           X
X           .       X             X       .           X
XXXXXXXXXXX . XXX   XXXXXXXXXXXXXXX   XXX . XXXXXXXXXXX
          X . XXX                     XXX . X
          X . XXX                     XXX . X
          X . XXX   XXXXXXXXXXXXXXX   XXX . X
XXXXXXXXXXX . XXX   XXXXXXXXXXXXXXX   XXX . XXXXXXXXXXX
X . . . . . . . . . . . . XXX . . . . . . . . . . . . X
X . XXXXXXX . XXXXXXXXX . XXX . XXXXXXXXX . XXXXXXX . X
X . XXXXXXX . XXXXXXXXX . XXX . XXXXXXXXX . XXXXXXX . X
X O . . XXX . . . . . . . . . . . . . . . . XXX . . O X
XXXXX . XXX . XXX . XXXXXXXXXXXXXXX . XXX . XXX . XXXXX
XXXXX . XXX . XXX . XXXXXXXXXXXXXXX . XXX . XXX . XXXXX
X . . . . . . XXX . . . . XXX . . . . XXX . . . . . . X
X . XXXXXXXXXXXXXXXXXXX . XXX . XXXXXXXXXXXXXXXXXXX . X
X . XXXXXXXXXXXXXXXXXXX . XXX . XXXXXXXXXXXXXXXXXXX . X
X . . . . . . . . . . . . . . . . . . . . . . . . . . X
XXXXXXXXXXXXXXXXXXXXXXXXXXXXXXXXXXXXXXXXXXXXXXXXXXXXXXX