XXXXXXXXXXXXXXXXXXXXXXXXXXXXXXXXXXXXXXXXXXXXXXXXXXXXXXX
X                         XXX                         X
X n . . . . n . . . . . n XXX n . . . . . n . . . . n h
X                         XXX                         X
X . XXXXXXX . XXXXXXXXX . XXX . XXXXXXXXX . XXXXXXX . h
X   XXXXXXX   XXXXXXXXX   XXX   XXXXXXXXX   XXXXXXX   X
X O XXXXXXX . XXXXXXXXX . XXX . XXXXXXXXX . XXXXXXX O X
X   XXXXXXX   XXXXXXXXX   XXX   XXXXXXXXX   XXXXXXX   X
X . XXXXXXX . XXXXXXXXX . XXX . XXXXXXXXX . XXXXXXX . X
X                                                     X
X n . . . . n . . n . . n . . n . . n . . n . . . . n X
X                                                     X
X . XXXXXXX . XXX . XXXXXXXXXXXXXXX . XXX . XXXXXXX . X
X   XXXXXXX   XXX   XXXXXXXXXXXXXXX   XXX   XXXXXXX   X
X . XXXXXXX . XXX . XXXXXXXXXXXXXXX . XXX . XXXXXXX . X
X             XXX         XXX         XXX             X
X n . . . . n XXX n . . n XXX n . . n XXX n . . . . n X
X             XXX         XXX         XXX             X
XXXXXXXXXXX . XXXXXXXXX   XXX   XXXXXXXXX . XXXXXXXXXXX
          X   XXXXXXXXX   XXX   XXXXXXXXX   X
          X . XXX                     XXX . X
          X   XXX d     d     d     d XXX   X
          X . XXX                     XXX . X
          X   XXX   XXXXXoooooXXXXX   XXX   X
XXXXXXXXXXX . XXX   X             X   XXX . XXXXXXXXXXX
X                   X             X                   X
h           n     d X   g g g g   X d     n           X
X                   X             X                   X
XXXXXXXXXXX . XXX   X             X   XXX . XXXXXXXXXXX
          X   XXX   XXXXXXXXXXXXXXX   XXX   X
          X . XXX                     XXX . X
          X   XXX d        p        d XXX   X
          X . XXX                     XXX . X
          X   XXX   XXvXXXXXXXXXXXX   XXX   X
XXXXXXXXXXX . XXX   XXvXXXXXXXXXXXX   XXX . XXXXXXXXXXX
X                         XXX                         X
X n . . . . n . . n . . n XXX n . . n . . n . . . . n X
X                         XXX                         X
h . XXXXXXX . XXXXXXXXX . XXX . XXXXXXXXX . XXXXXXX . X
X   XXXXXXX   XXXXXXXXX   XXX   XXXXXXXXX   XXXXXXX   X
X . XXXXXXX . XXXXXXXXX . XXX . XXXXXXXXX . XXXXXXX . X
X       XXX                                 XXX       X
X O . n XXX n . . n . . n . . n . . n . . n XXX n . O X
X       XXX                                 XXX       X
XXXXX . XXX . XXX . XXXXXXXXXXXXXXX . XXX . XXX . XXXXX
X             XXX         XXX         XXX             X
X n . n . . n XXX n . . n XXX n . . n XXX n . . n . n X
X             XXX         XXX         XXX             X
X . XXXXXXXXXXXXXXXXXXX . XXX . XXXXXXXXXXXXXXXXXXX . X
X                                                     X
X n . . . . . . . . . . n . . n . . . . . . . . . . n X
X                                                     X
XXXXXXXXXXXvXXXXXXXXXXXXXXXvXXXXXXXXXXXXXXXXXXXXXXXXXXX